11111011111
10001000001
10101111101
10100000001
10111011111
10001000101
10101010101
10101010001
10101110111
10100010001
11111011111